#TTT#TTG##TT#TTTTT
##TTTTTT#TTT#TTTT#
T#TTT#TT#TTTT#TTTT
TTTTT#TTTT#TTTT#T#
#TTT#T#T#T#T#T#TTT
#TTTTT#T#T#T#TT#T#
T##TTT##TT#TTTTTTT
T##TTTTTGTT##TTTTT
#T#TTTTTTG##T#TT#T
TTTTT#TTTTTTTTTTT#
