TTTT####TTT####T#T
TTT#TT#TTT#TTT#TT#
TT#TTT#TT#TT#TT#T#
##TT#TTTTTTTTTTTT#
TTTTT#TT#TTTTTT#TT
TTTTTTTTTT#GT#TTTT
#TTTTT#TTT#TTTT#TT
TTTTTTTTTTTT#T#TTT
#T##TTTTTT#TTTTTTG
TTTTTTTTTTTTT#TTTT
