TTT#TT#TTT#T#TT#TT
TTTTTT#TT#TTTTTTT#
TT#TT#TTTTTTT#TTT#
T#TTT###TTTT##TT#T
##TTTTTTTTTTT#T#TT
TTTTTTTTT#TTT##TTT
TTTT##T##TTTTT##TT
TT#TT#TTTTTTTTT#TT
T#T##TTTTTTTT#TT#T
TTTTTTTTTT#TT#TGTT
