#TTTTTGTTTET##TTTT
#TTTT#TTETTTTTTTTT
####TTTGGT#E##G#T#
TETTTT#TT#EETTTT#T
TTGT#GT###TTTTGT#T
TSTGTT#TTTTE#TGTTT
TTTTG#TTTG#TTT#TTE
GGTE#GTETT##T#GT#T
##TTGTTTTT###TGTT#
TGTTTTTTTTTTTGTTTT
