#TTTTTTTTTTT#TT###
TT#TT#TT##T#TT#TTT
TT#T#TTT#TTTTTT#TT
T##TTT#T#TT#T##TTT
TTTT#GTTTT#TTTTTTT
TTTT#TTTTTTTT#TTTT
TTTT#TTT#TTT#TTTTT
#TTTT#TTTTT#TTTT#T
T#TT#TTTTTTTTTTTTT
TTTTTTTT##T#T#TTTT
