GTTTT##T##TTTT#TST
TT#TTET##TET##TT#T
TTTTETT#TTETETTG#T
TTTTTG##TTG#TTGTTT
TGTTETTTTTGTGGTTTT
#TEGE##TTTTTTTT#TT
TETTTTTTETT##TGTTT
#TTGT#TG###TT#TTTT
TTT#TTTTTTTTT#T#T#
#TETTTE#TTTTT##GTT
