ETTTE#TT##TTT#GT#G
#TT#E#ETETTTTT#EST
TTTTTG#T#G#TETTT##
#TTTTTTTTTTTT##TTG
TTTTTTTTTG#TTTTTG#
TETGTETTGETTTT#TTT
#TTTTG##TTTTTTT###
T##TT#TG#TT#TETTTT
TT#GTTTTTT#EETT#T#
#TTTTTTT#TT#E####G
