TTTTGT#TTTTTT#TT#T
T#TTT#T#TTT##TTTT#
T##TTTTT#TTTTT#T#T
GGTTTTTTTTTTT#TTTT
TTTTTTTT#T#TT#TT#T
TT#T##TTT#TTTTTTTT
T#TTTTTGT#TTT#TTTT
T#T##TTTTTTTTT#TTT
#TTTGTTT#TTT#TTT#T
TTGTTTTTTTTTTT#TTT
