ETTTTTTTETTT#T#ETG
TTTT##ETTTTTTTTTTT
TTT#TT#TTGTTTTTTT#
TTTT#TE#E#TTTTTTT#
TT#TT#T#TTG#TTG#TT
TTTTTSTTT##TTTGTTT
TGET#TTTT#TTTE#T##
TT##T###TTET#TT#T#
T#TTETGTTT#ET#T##T
G#TGTT#TGTTTTTTTTG
