#TT#T#TTTTTTTTGT#T
TT#T##TTTTT##T#TT#
TT#TTT#TTTTGTTT##T
TTTT#TT#T#TTTTG#TT
TTTTT#TTG#TT#T#TTT
T#TTT#TG#####TTTT#
TTT#TTTTTTTTTTTTTT
TT###TTT#TTT#TTTTT
TT#TTTT#TT#TTTTT#T
TTTTTT#TGTTT#T###T
