#TT#T#TTTTTTTTTTT#
TTT#TT#TTTTTT###TT
GT##TTTTT#TTTTTTTT
#TTTTTTT#T##T#TT#T
T#TTTTG#TT#TTTTT#T
TTTTTTTTTTTTT#TTTT
#T#TTTTT#TTTTTTTTT
TTT#T#T#T#TT#TT#TG
TTTTTTTTTTTT##TTTT
TTT#TT##TT##TTTTG#
