#GTETETTTTTTTTT##T
TGTTTTTTET#ETTT##T
TTT#T#GTTET#ETG#ET
ETT#TS#G#TTTT##TTE
TT##TTTTT#T#TTTTTE
TTT##TTTETETTTTTTT
TTE##TT#T#E###TGTT
TTGTT#TGTTTT##TTGE
#T#E#TTTTTT#TTTETT
TT#TTTGTTT#GE#ETT#
