##################
#                #
#                #
#                #
#       s        #
#                #
#                #
#                #
#                #
##################