 #  G        #    
    #   #         
  ###  ###        
 # ## #           
 ##  #  #         
 #    #      # # #
#   #   #    ## # 
 ## ## #          
# #  #  ##### # # 
   #     #   ##   
