TE##GTTTT#T#G#TGTT
GTETTTTTTTTTTETTGT
T#TGGTT#SE#TTTTTGT
#TT#GTEGTT##TGTTT#
ETTTGTE#T#T###TG#T
TTT#TTTTTTTG#TT#TT
TTGTTTTTTT#E#TE##E
##TTTTE#TTTETTT#TT
TTTTT###TTG#GTTTTT
G#GT##TTTTTTTET#T#
