TTTTTTTTT#TTT#TTTT
T#S#TTETETTTTGT#TT
TGT#TTG###T#TTETT#
T#T#T#TT#T#TTTTT#G
TETTT##TTETTT#T##E
T##TTTTTTTGTTTTTTE
TGGTTTTTT#GTTT#GTT
TTTGTTT##T#TTTTTTG
TT#TTGT###ETT#GTGE
#TTT#TTG#TTGTTTTTT
