TTGTT##TE#TT#TT#T#
GTTTT#T#T#STTTTTTT
TT#G#TTTET#TTGTTTT
TTTT#TT##TTTTE#TTT
#GTT##T#TTT##TTTTT
#TTTTET#T#GTTTTET#
TTTT#TTTTTTG#G#TTT
TTGTTTTTTGGTTGTTTT
#T#T##TTT#TGET#T#T
GTT##TETETT#TTTTTT
