   G    # #     # 
     #  #    ###  
   #    #         
   #  #          #
         #  #    #
 # #       #      
 # #          #  #
 #           #    
 #   ##    # #    
   ##  #  #       
