T#TTTT#T#TT#TTTTT#
#TTTTTTTTTT#TTTGTT
TTT#TTGTTTT#TTTTTT
T#T#TTTTTTT#TTT#TT
#TTTTGTT##T#TT##TT
TTTTTTTTTT#TTTTT#T
TTTTT#T#TTT#TTTT#T
T##TTTTTTTTT#TGTTT
TTTT#T#TTTTTTTTTTT
#TTT#TTT#T#TTGTTTT
