TTT#TG#TT#TT#T#TTT
TTTTTTT#TTTTTTTT#T
TTTT##TTGT#TTT#TTT
##T#T##TT##TTTTTT#
TTT#TTTT#TTTTTTTTT
TTTT#TT##TTTTT#T##
###T##TTTTTTTT####
TTT##TTTTTTT##TTT#
TTT##TT#T#TTTT#TT#
TTTT###TTT#TTTTTTT
