TTTTT#TT##TT#TT#TT
T##TT#TT##TTTTTTT#
GTT##TTTT#TT#TTTTT
#TTT#TTT#TTTT#T##T
T#T#TTTTTGT#####TT
TTT#T#T#T#TTTTT#T#
TT#TTTTTTTT#TTTT#T
#TTTTTT#TTTTTTT#T#
TTTT#TT#TT#TGT#TTT
TT#TTTTTTTTT#GTTTT
