#TT#TTTT#TTTTTTTTT
TTTTTT#TTT##TTTT#T
TTT##T#T###TTTGTTT
#TT#TTTTTTTTTTTTTT
TT##TTTGTT#T#TTT#T
T##TGTTTT#TTT#TTTT
T##TTTTT#TTTTT#TTT
TT#TTTTTTTT#TTTT#T
TTTTT#TTTTTTTT#T#T
T#TTTTTTTTT#T#TT##
